WE ./textures/wall1.png
EA ./textures/wall2.png
C 0,0,0
NO ./textures/wall3.png
SO ./textures/wall4.png
F 37, 55,  56

111111
100001
10E11
1000111
1111111
