WE path
EA path
C 0,0,134
NO path
SO path
F 33, 3,  3

111111
100001
10E11
1000111
1111111
