WE ./textures/wall3.png
EA ./textures/wall2.png
F 37, 55,  56
NO ./textures/wall1.png
SO ./textures/wall5.png
C 0,0,0

111111111111111111111111
100001000100001010010011
101000000000100100000001
100001001000100001000111
100100001000000000001001
10E001001000100010000011
100100001001000000100001
100010010001000100001011
100010001000001000010101
111111111111111111111111
