WE ./textures/wall1.png
EA ./textures/wall2.png
C 0,0,0
NO ./textures/wall3.png
SO ./textures/wall4.png
F 37, 55,  56

111111111111111111111111
100001000100001000010011
100000000000000000000001
100000000000000000000011
100000000000000000000001
10E000000000000000000011
100000000000000000000001
100010000000000000000011
100010001000001000010001
111111111111111111111111
