WE path
EA path
C 0,0,134
NO path
SO path
F 33, 3,  3

11111111111111111111
11111111111111111111
11E00000000000000000
11111111111111111111
