NO ./textures/wall1.png
SO ./textures/wall2.png
WE ./textures/wall3.png
EA ./textures/wall4.png
F 37, 55,  56
C 0,0,0

111111111111111111111111
100000100110000101000011
10111111_110100100000001
1010||||0000100010001111
101_111110011000001001001
101001100010000101001111
1001_10011110000010100001
100|N|1001000100010000101
1001_10000000000000000011
111111111111111111111111
