NO ./textures/wall1.png
SO ./textures/wall2.png
WE ./textures/wall3.png
EA ./textures/wall4.png
F 37, 55,  56
C 0,0,0

111111111111111111111111
100000100110000101000011
100000000010100100000001
100000001000100001000111
100000001000000001001001
100000010001000010100111
1000000011110000010100001
1N0000010001000100001011
100000000000000000000001
111111111111111111111111
