NO ./textures/walls/wall1.png
SO ./textures/walls/wall2.png
WE ./textures/walls/wall3.png
EA ./textures/walls/wall4.png
F 37, 55,  56
C 0,0,0


111111111111111111111111
100000000000000000000001
100000000000000000000001
100000000000000000000001
100000000000000000000001
100000000000000000000001
100000000000000000000001
100000000000000000000001
100000000000000000000001
100000000000000000000001
1000000000N0000000000001
111111111111111111111111
