NO ./textures/walls/wall1.png
SO ./textures/walls/wall2.png
WE ./textures/walls/wall3.png
EA ./textures/walls/wall4.png
F 0,0,0
C 0,0,0

111111111111111111111111
1e00001001100e0101000011
10111111_1101001000000e1
1010||||000010e010001111
101_111110011000e01001001
101e011e0010000101001111
1e01_100111100e0010100001
100|N|1001000100010000101
1001_100000000000000e00011
111111111111111111111111
